2 2 2 1 1 2 2 2 2 2 2 2 2 2 1 2 
2 4 4 4 4 4 5 4 4 4 4 3 4 4 4 2
2 4 3 4 4 4 4 4 4 4 4 4 4 4 4 1
2 4 4 4 4 4 4 3 4 4 5 4 4 4 4 2
2 4 5 4 4 4 4 4 4 4 4 4 4 3 4 3
2 4 4 4 3 4 4 4 5 4 4 4 4 4 4 3
1 4 3 4 4 4 4 4 4 4 4 4 4 4 4 3
1 4 5 4 4 4 3 4 4 4 4 3 4 4 4 3
2 4 4 4 4 4 4 4 4 4 4 4 4 4 4 2
1 4 4 4 3 4 4 4 4 4 5 4 4 4 4 2
2 4 4 4 4 4 4 4 4 4 4 4 4 3 4 1
1 2 2 2 2 2 1 1 1 2 2 2 2 2 2 2